S.X...G.
...X....
...X....
........
.X.X....
.X.X....
...X....
........
